2	2	2	0	0	0	0	0	0	0	0	0	0	0	0	0	0	0	0	0	0	3	7	0	0	0	0	0	0	3	0	0	0	0	0	0	0	0	0	3	7	0	0	0	0	0	0	0	0	0
2	2	2	0	0	0	0	0	0	0	0	0	0	0	0	2	2	2	0	0	0	3	0	0	0	0	0	0	0	3	0	0	0	0	0	0	0	0	0	3	0	0	0	0	0	0	0	0	0	0
2	2	2	0	0	0	0	2	2	2	0	0	0	0	0	2	2	2	0	0	0	3	0	0	0	0	0	0	0	3	0	0	0	2	2	2	0	0	0	3	0	0	0	0	0	0	0	0	0	0
0	0	0	0	0	0	0	2	2	2	0	0	0	0	0	2	2	2	0	0	0	3	3	3	3	3	3	3	3	3	0	0	0	2	2	2	0	0	0	3	3	3	3	3	3	3	3	3	3	3
0	0	0	0	0	0	0	2	2	2	0	0	0	0	0	8	0	0	0	0	0	0	4	4	4	0	0	0	0	0	4	4	4	4	2	2	0	0	0	0	0	0	2	2	2	0	0	0	0	0
0	7	0	0	0	0	0	0	0	0	0	0	0	4	0	0	0	0	0	0	4	4	4	4	4	0	0	0	2	2	4	4	4	4	0	0	0	0	0	0	0	0	2	4	4	4	0	0	0	0
0	0	0	0	0	0	0	0	0	0	0	4	4	4	0	0	0	0	0	0	0	0	4	4	4	0	0	0	2	2	4	4	4	4	4	4	0	0	0	0	0	0	2	4	4	4	0	0	0	0
0	0	0	0	0	0	0	0	0	0	4	4	4	4	4	0	0	0	0	0	0	0	4	0	0	0	0	0	2	2	4	4	4	4	0	0	0	0	0	0	0	0	0	4	4	4	0	0	0	0
0	0	0	0	0	0	0	0	0	0	4	4	4	0	0	0	2	2	2	0	0	0	4	0	0	0	0	0	0	0	4	4	4	0	0	0	0	0	0	0	0	0	4	4	4	4	0	0	0	0
0	0	0	0	0	0	0	0	0	0	4	0	0	0	0	0	2	2	2	0	0	0	4	0	0	0	0	4	4	4	4	4	4	0	0	0	0	0	0	2	2	2	4	4	4	0	0	0	0	0
0	0	2	2	2	0	0	0	2	2	2	0	0	0	0	0	2	2	2	0	0	0	0	0	0	0	0	4	4	4	4	4	4	0	0	0	0	0	0	2	4	4	4	4	4	0	0	2	2	2
0	0	2	2	2	0	0	0	2	2	2	4	4	0	0	0	0	0	0	0	0	0	0	0	0	0	0	0	0	0	0	0	0	0	0	0	0	0	0	2	4	4	4	0	0	0	0	2	2	2
0	0	2	2	2	0	0	0	2	2	2	4	4	0	0	0	0	0	0	0	0	0	0	0	0	0	0	0	0	0	0	0	0	0	0	0	0	0	0	0	4	4	4	4	4	4	0	2	2	2
0	0	0	0	0	0	0	0	4	4	4	4	4	0	0	0	0	0	0	0	0	0	0	0	0	0	0	0	0	0	0	0	0	0	4	4	4	0	0	0	0	0	0	0	0	0	0	0	0	0
0	0	0	0	0	0	4	4	4	4	4	4	0	0	2	2	2	0	0	0	0	2	2	2	0	0	0	2	2	2	0	0	0	0	0	0	0	0	0	0	0	0	0	0	0	0	0	0	0	0
0	0	0	0	0	0	4	4	4	0	0	4	0	0	2	2	2	0	0	0	0	2	2	2	0	0	0	2	2	2	0	0	0	0	0	2	2	2	0	0	0	0	0	0	4	0	0	0	0	0
0	0	0	0	0	0	0	0	0	0	0	4	0	0	2	2	2	0	0	0	0	2	2	2	0	0	0	2	2	2	0	0	0	0	0	2	2	2	0	0	0	4	0	0	4	0	0	0	0	0
0	0	0	0	0	0	0	0	0	0	0	0	0	0	0	0	0	0	0	0	0	0	0	0	0	0	0	0	0	0	0	0	0	0	0	2	2	2	0	0	0	4	0	0	4	0	0	0	0	0
0	0	0	0	0	0	0	0	0	0	0	0	0	0	0	0	0	0	0	0	0	0	0	0	0	0	0	0	0	0	0	0	0	0	0	0	0	0	0	4	4	4	4	4	4	4	0	0	0	0
0	0	0	0	0	0	0	0	0	0	0	0	0	0	0	0	0	0	0	0	0	0	0	0	0	0	0	0	0	0	0	0	0	0	0	0	0	0	0	4	4	4	4	4	4	4	0	0	0	0
0	0	0	0	0	0	0	0	2	2	2	2	2	2	0	0	2	2	2	0	0	0	0	0	0	0	0	0	0	0	0	4	4	4	0	0	0	0	0	4	4	4	4	4	4	4	0	0	0	0
0	0	7	0	0	0	0	0	2	2	2	2	2	2	0	0	2	2	2	0	0	0	0	0	0	0	0	0	2	2	2	4	4	4	4	4	0	0	0	0	0	2	2	2	0	0	0	0	0	0
0	0	0	0	0	0	0	0	2	2	2	2	2	2	0	0	2	2	2	0	0	0	0	0	0	0	0	0	2	2	2	4	4	4	4	4	0	0	0	0	0	2	2	2	0	0	2	2	2	0
0	0	0	0	0	0	0	0	0	4	4	4	4	4	0	0	0	0	0	0	0	0	5	0	0	0	0	0	2	2	2	4	4	4	0	2	2	2	0	0	0	0	0	0	0	0	2	2	2	0
0	0	0	0	0	0	0	0	0	4	0	4	4	4	0	0	0	0	0	0	0	0	0	0	0	0	0	0	0	0	0	0	0	0	0	2	2	2	0	0	0	0	0	0	0	0	2	2	2	0
0	0	0	0	0	0	0	0	0	0	0	4	4	0	0	0	0	0	0	0	0	0	0	0	0	0	0	0	0	4	4	4	4	0	0	2	2	2	0	0	0	0	0	0	0	0	0	0	0	0
0	0	0	0	0	0	0	0	0	0	0	4	4	0	0	2	2	2	4	4	0	0	0	0	0	4	4	4	4	4	4	4	4	0	0	0	0	0	0	0	0	0	0	4	4	4	4	0	0	0
0	0	0	0	0	0	0	0	0	0	0	2	2	2	0	2	2	2	4	4	0	0	0	0	0	0	0	0	0	4	4	4	4	0	0	0	0	0	0	0	0	0	0	4	4	4	4	0	0	0
0	0	0	0	2	2	2	0	0	0	0	2	2	2	0	2	2	2	4	4	4	4	4	0	0	0	0	0	0	0	0	0	0	0	0	0	7	0	0	2	2	2	0	0	4	4	4	0	0	0
0	0	0	0	2	2	2	0	0	0	0	2	2	2	0	0	0	0	4	4	4	4	4	0	0	0	0	0	0	2	2	2	0	0	0	0	0	0	0	2	2	2	0	0	4	4	4	0	4	0
0	0	0	0	2	2	2	0	0	0	0	0	0	0	0	0	0	0	4	0	0	2	2	2	0	0	0	0	0	2	2	2	0	0	0	0	0	0	0	2	2	2	0	0	4	4	4	0	4	0
0	0	0	0	0	0	0	0	0	0	0	0	0	0	0	0	0	0	4	0	0	2	2	2	0	7	0	0	0	2	2	2	0	0	0	0	0	0	0	0	0	4	4	4	4	4	0	0	4	0
0	0	0	0	0	0	0	0	0	0	0	0	0	0	0	0	2	2	2	0	0	2	2	2	0	0	0	0	0	0	0	0	0	0	0	0	0	0	0	0	0	4	4	4	4	4	4	4	4	0
0	0	0	0	7	0	0	0	0	0	0	0	0	0	0	0	2	2	2	0	0	0	0	0	0	0	0	0	0	0	0	0	0	0	2	2	2	0	0	0	0	4	4	4	4	4	0	0	0	0
0	0	0	0	0	0	0	0	0	0	0	2	2	2	0	0	2	2	2	0	0	0	0	0	0	0	0	0	0	0	0	0	0	0	2	2	2	0	7	0	0	0	0	0	0	0	0	0	0	0
0	0	0	0	0	0	0	0	0	0	0	2	2	2	0	0	0	0	4	4	4	0	0	0	0	0	0	0	0	0	0	0	0	0	2	2	2	0	0	0	0	0	0	0	0	0	0	0	0	0
0	0	0	0	0	0	0	0	0	0	0	2	2	2	0	0	0	0	4	4	4	0	0	0	0	2	2	2	0	0	0	0	0	0	0	0	0	0	0	0	0	0	0	0	0	0	0	0	0	0
0	0	0	2	2	2	0	0	0	0	0	0	0	0	0	0	4	4	4	4	4	0	0	0	0	2	2	2	0	4	4	4	0	0	0	0	0	0	0	0	0	0	0	0	0	0	0	0	0	0
0	0	0	2	2	2	0	0	0	0	0	0	0	0	0	0	4	4	4	4	4	0	0	0	0	2	4	4	4	4	4	4	0	0	0	0	0	4	4	4	4	4	4	4	0	0	0	0	0	0
0	0	0	2	2	2	0	0	0	0	2	2	2	0	0	0	4	4	4	4	4	0	2	2	2	0	4	4	4	4	4	4	0	0	0	0	0	4	4	4	4	4	4	4	0	0	0	0	0	0
0	0	0	0	0	0	0	0	0	0	2	2	2	0	0	0	0	0	0	0	0	0	2	2	2	4	4	4	4	4	0	0	0	0	4	4	4	4	4	4	4	4	4	4	2	0	0	0	0	0
0	0	0	0	0	0	0	0	0	0	0	0	0	0	0	0	0	2	2	2	0	0	0	0	0	0	0	0	0	0	0	0	0	4	4	4	4	4	4	0	0	0	0	0	0	0	0	0	0	0
0	0	0	2	2	2	0	0	0	0	0	0	0	0	0	0	0	0	0	0	0	0	0	0	0	0	0	0	0	0	0	0	0	0	0	0	0	0	0	0	0	0	0	0	0	0	0	0	0	0
0	0	0	0	0	0	0	0	0	0	0	0	0	0	0	0	0	0	0	0	0	0	0	0	0	0	0	0	0	0	0	0	0	0	0	0	0	0	0	0	0	0	0	0	0	0	0	0	0	0
0	0	0	0	0	0	0	0	0	0	2	2	2	0	0	0	0	0	2	2	2	0	2	2	2	0	4	4	4	4	0	0	0	0	4	4	4	4	4	4	0	0	2	2	2	0	0	0	0	0
0	0	0	0	0	0	0	0	0	0	0	0	0	0	0	0	0	0	2	2	2	0	0	0	0	0	0	0	0	0	0	0	0	0	4	4	4	4	4	4	0	0	2	2	2	0	0	0	0	0
0	0	0	0	0	0	0	0	0	0	0	0	0	0	0	0	0	0	2	2	2	0	0	0	0	0	0	0	0	0	0	0	0	0	4	4	4	4	4	4	0	0	0	0	0	0	0	0	0	0
0	0	0	0	0	0	0	0	0	0	0	0	0	0	0	0	0	0	0	0	0	0	0	0	0	0	0	0	0	0	0	0	0	0	0	0	0	0	0	0	0	0	0	0	0	0	0	0	0	0
0	0	0	0	0	0	0	0	0	0	0	0	0	0	0	0	0	0	0	0	0	0	0	0	0	0	0	0	0	0	0	0	0	0	0	0	0	0	0	0	0	0	0	0	0	0	0	0	0	0
0	0	0	0	0	0	0	0	0	0	0	0	0	0	0	0	0	0	0	0	0	0	0	0	0	0	0	0	0	0	0	0	0	0	0	0	0	0	0	0	0	0	0	0	0	0	0	0	0	0
